1111111111111 1111
1C0100C0000C1 1001
1000011000001 1001
110011E000P01 1001
1111111111111 1111


