111111111111111111111111111
1C0100C00000CCCCCCCCCCCCC11
1000011111000CCCCCCCCCC1111
1000011111000CCCCCCCCCCC111
1000011111000CCCCCCCCCC1111
1000011111000CCCCCCCCCC1111
1000011111000CCCCCCCCCC1111
1000011111000CCCCCCCCCC1111
1000011111000CCCCCCCCCC1111
1000011111000CCCCCCCCCC1111
1000011111000CCCCCCCCCC1111
1000011111000CCCCCCCCCC1111
1000011111000CCCCCCCCCC1111
1000011111000CCCCCCCCCC1111
1000011111000CCCCCCCCCC1111
1000011111000CCCCCCCCCC1111
1000011111000CCCCCCCCCC1111
1000011111000CCCCCCCCCC1111
1000011111000CCCCCCCCCC1111
1000011111000CCCCCCCCCC1111
1000011111000CCCCCCCCCC1111
110011E000P00CCCCCCCCC11111
111111111111111111111111111