1111111111111111111111
110100C0000C0000000001
1100011111000111100001
100011E000P0001110C001
1111111111111111111111