1111111111111
1P0C000C00E11
1111111111111