11111111111111111
10010000000000001
10000111110001111
11E0110000P000001
11111111111111111
