111111111111111
1C00C0000C00001
100111110001111
11011000P000001
111111111111111
