11111111111111111
0C0100C0000C00001
00000111110001111
010011E000P000001
11111111111111111
