11111111111111111
1C0100C0000C00001
10000111111111111
110011E000P000001
11111111111111111
